11111111111111111111111111111111111111111111111111111111
1P000000000000000000000000000000000000000000000000000001
10111110100000000000000000000000000000000000000000000001
1C00000E100000000000000000000000000000000000000000000001
10000000000000000000000000000000000000000000000000000001
10000000000000000000000000000000000000000000000000000001
10000000000000000000000000000000000000000000000000000001
10000000000000000000000000000000000000000000000000000001
10000000000000000000000000000000000000000000000000000001
10000000000000000000000000000000000000000000000000000001
10000000000000000000000000000000000000000000000000000001
10000000000000000000000000000000000000000000000000000001
10000000000000000000000000000000000000000000000000000001
10000000000000000000000000000000000000000000000000000001
10000000000000000000000000000000000000000000000000000001
10000000000000000000000000000000000000000000000000000001
10000000000000000000000000000000000000000000000000000001
10000000000000000000000000000000000000000000000000000001
10000000000000000000000000000000000000000000000000000001
10000000000000000000000000000000000000000000000000000001
10000000000000000000000000000000000000000000000000000001
11111111111111111111111111111111111111111111111111111111
