NO ./textures/nord.xpm
SO ./textures/sud.xpm
WE ./textures/ouest.xpm
EA ./textures/est.xpm
F 220,100,0
C 225,30,0

1111 1
100001
1000N1
100001
111111
