NO ./textures/nord.xpm
SO ./textures/sud.xpm
WE ./textures/ouest.xpm
EA ./textures/est.xpm
F 220,100,0
C 225,30,0

111111
10N001
1000S1
100001
111111
