NO ./textures/nord.xpm
SO ./textures/sud.xpm
WE ./textures/ouest.xpm
EA ./textures/est.xpm
F 50,50,50
C 100,100,100

11111111111111111111
10000010000000000001
10111010111111111101
10100010000000000101
10101111111111110101
10101000000000010101
10101011111111010101
10101010000001010101
10101010111101010101
10100010100101000101
1011111010N101111101
10000000100100000001
11111111111111111111