NO ./textures/nord.xpm
SO ./textures/sud.xpm
WE ./textures/ouest.xpm
EA ./textures/est.xpm
F 210,210,210
C 20,20,60

111111111111
100000000001
1011111110 1
10100000010 1
101011010 1
101011010 1
10101S010 1
1010000010 1
1011111110 1
100000000001
111111111111
