NO ./textures/nord.xpm
SO ./textures/sud.xpm
WE ./textures/ouest.xpm
EA ./textures/est.xpm
F 210,210,243
C 20,20,60

111111111111
100000000011
101111111101
101000000101
101011010101
101011010101
10101S010101
101000001011
101111111011
100000000001
111111111111
