NO ./textures/nord.xpm
SO ./textures/sud.xpm
WE ./textures/ouest.xpm
EA ./textures/est.xpm
F 30,30,30
C 90,90,90

  1111
  1W011
111011
1000001
1000001
111111
